13
13
47,47,47,47,47,47,47,47,47,47,47,47,47,
47,0,47,0,47,0,47,0,47,0,47,0,47,
47,0,47,0,47,0,47,0,47,0,47,0,47,
47,0,47,0,47,0,8,0,47,0,47,0,47,
47,0,47,0,47,1,47,1,47,0,47,0,47,
3,47,47,47,47,0,47,0,47,47,47,47,3,
9,47,0,0,47,47,47,47,47,0,0,47,9,
47,47,47,47,47,3,47,3,47,47,47,47,47,
47,0,47,0,47,0,0,0,47,0,47,0,47,
47,0,47,0,47,0,47,0,47,0,47,0,47,
47,0,47,0,47,0,47,0,47,0,47,0,47,
47,0,47,0,47,47,3,47,47,0,47,0,47,
47,47,47,47,47,4,13,2,47,47,47,47,47,
