13
13
47,47,47,8,47,47,47,8,47,47,47,47,47,
47,0,47,8,47,47,47,0,47,0,47,0,47,
47,0,47,47,47,47,0,0,47,0,8,0,47,
47,47,47,0,47,47,47,47,47,8,47,47,47,
6,47,47,0,47,47,8,47,47,0,6,0,8,
6,6,47,47,47,0,47,47,8,47,6,47,47,
47,0,0,0,6,6,6,8,47,47,6,0,47,
47,47,47,8,6,0,47,0,47,0,47,0,47,
8,0,47,8,47,0,47,0,47,47,47,0,47,
47,0,47,0,47,0,0,0,47,0,8,0,47,
47,0,47,0,47,0,0,0,47,47,47,47,47,
47,0,47,47,47,47,3,47,47,0,47,0,47,
47,0,47,0,47,4,13,2,47,0,0,0,47,
